"filename", "language", "MATLAB", "comment", "blank", "total"
"e:\Openlab\gitlib\project\pusch\pusch_dim_reduce\matlab\data64ants\antData.mat", "MATLAB", -10756, 0, -70, -10826
"e:\Openlab\gitlib\project\pusch\pusch_dim_reduce\matlab\data64ants\antData_fix.mat", "MATLAB", -2817, 0, -18, -2835
"e:\Openlab\gitlib\project\pusch\pusch_dim_reduce\matlab\data64ants\ant_data.mat", "MATLAB", -6, 0, 0, -6
"e:\Openlab\gitlib\project\pusch\pusch_dim_reduce\matlab\data64ants\beam_data.mat", "MATLAB", -14, 0, 0, -14
"e:\Openlab\gitlib\project\pusch\pusch_dim_reduce\matlab\data64ants\beam_data_even.mat", "MATLAB", -9, 0, 0, -9
"e:\Openlab\gitlib\project\pusch\pusch_dim_reduce\matlab\data64ants\beam_data_odd.mat", "MATLAB", -20, 0, 0, -20
"e:\Openlab\gitlib\project\pusch\pusch_dim_reduce\matlab\data64ants\codeWord.mat", "MATLAB", -126, 0, -1, -127
"e:\Openlab\gitlib\project\pusch\pusch_dim_reduce\matlab\data64ants\codeWord64.mat", "MATLAB", -454, 0, -1, -455
"e:\Openlab\gitlib\project\pusch\pusch_dim_reduce\matlab\data64ants\codeWord64_fix.mat", "MATLAB", -128, 0, 0, -128
"e:\Openlab\gitlib\project\pusch\pusch_dim_reduce\matlab\data64ants\codeWord_fix.mat", "MATLAB", -28, 0, 0, -28
"e:\Openlab\gitlib\project\pusch\pusch_dim_reduce\matlab\data64ants\compress_data.mat", "MATLAB", -1522, 0, -4, -1526
"e:\Openlab\gitlib\project\pusch\pusch_dim_reduce\matlab\data64ants\des_beams_data.mat", "MATLAB", -7063, 0, -16, -7079
"e:\Openlab\gitlib\project\pusch\pusch_dim_reduce\matlab\data64ants\des_beams_idx.mat", "MATLAB", -6, 0, 0, -6
"e:\Openlab\gitlib\project\pusch\pusch_dim_reduce\matlab\data64ants\des_beams_pwr.mat", "MATLAB", -24, 0, 0, -24
"e:\Openlab\gitlib\project\pusch\pusch_dim_reduce\matlab\data64ants\des_beams_sort.mat", "MATLAB", -13, 0, 0, -13
"e:\Openlab\gitlib\project\pusch\pusch_dim_reduce\matlab\data64ants\des_rx_data.mat", "MATLAB", -35, 0, -3, -38
"e:\Openlab\gitlib\project\pusch\pusch_dim_reduce\matlab\data64ants\des_tx_data.mat", "MATLAB", -49, 0, 0, -49
"e:\Openlab\gitlib\project\pusch\pusch_dim_reduce\matlab\data64ants\des_unzip_data.mat", "MATLAB", -9, 0, 0, -9
"e:\Openlab\gitlib\project\pusch\pusch_dim_reduce\matlab\data\antData.mat", "MATLAB", -5380, 0, -43, -5423
"e:\Openlab\gitlib\project\pusch\pusch_dim_reduce\matlab\data\antData_fix.mat", "MATLAB", -1487, 0, -9, -1496
"e:\Openlab\gitlib\project\pusch\pusch_dim_reduce\matlab\data\codeWord.mat", "MATLAB", -57, 0, 0, -57
"e:\Openlab\gitlib\project\pusch\pusch_dim_reduce\matlab\data\codeWord_fix.mat", "MATLAB", -19, 0, 0, -19
"e:\Openlab\gitlib\project\pusch\pusch_dim_reduce\matlab\data\sim_beam.mat", "MATLAB", -38, 0, 0, -38
"Total", "-", -30060, 0, -165, -30225