"filename", "language", "MATLAB", "comment", "blank", "total"
"e:\Openlab\gitlib\project\pusch\pusch_dim_reduce\matlab\alaw_sim.m", "MATLAB", 13, 0, 5, 18
"e:\Openlab\gitlib\project\pusch\pusch_dim_reduce\matlab\beams_time_interleaved_sim.m", "MATLAB", 75, 0, 54, 129
"e:\Openlab\gitlib\project\pusch\pusch_dim_reduce\matlab\comb_ants_script.m", "MATLAB", 163, 0, 76, 239
"e:\Openlab\gitlib\project\pusch\pusch_dim_reduce\matlab\comb_vector_script.m", "MATLAB", 223, 0, 90, 313
"e:\Openlab\gitlib\project\pusch\pusch_dim_reduce\matlab\cpri_data_gen.m", "MATLAB", 50, 0, 36, 86
"e:\Openlab\gitlib\project\pusch\pusch_dim_reduce\matlab\cpri_rxdata_8lanes_sim.m", "MATLAB", 77, 0, 51, 128
"e:\Openlab\gitlib\project\pusch\pusch_dim_reduce\matlab\cpri_verctor_vfy.m", "MATLAB", 534, 0, 198, 732
"e:\Openlab\gitlib\project\pusch\pusch_dim_reduce\matlab\dim_reduction_64ants_sim.m", "MATLAB", 91, 0, 45, 136
"e:\Openlab\gitlib\project\pusch\pusch_dim_reduce\matlab\dim_reduction_sim.m", "MATLAB", 64, 0, 45, 109
"e:\Openlab\gitlib\project\pusch\pusch_dim_reduce\matlab\dl_beams.m", "MATLAB", 188, 0, 103, 291
"e:\Openlab\gitlib\project\pusch\pusch_dim_reduce\matlab\dl_beams_abs2_pwr.m", "MATLAB", 281, 0, 140, 421
"e:\Openlab\gitlib\project\pusch\pusch_dim_reduce\matlab\dl_beams_pwr.m", "MATLAB", 294, 0, 137, 431
"e:\Openlab\gitlib\project\pusch\pusch_dim_reduce\matlab\dl_sim.m", "MATLAB", 157, 0, 89, 246
"e:\Openlab\gitlib\project\pusch\pusch_dim_reduce\matlab\dr128_vector_vfy.m", "MATLAB", 530, 0, 201, 731
"e:\Openlab\gitlib\project\pusch\pusch_dim_reduce\matlab\dr_vector_vfy.m", "MATLAB", 380, 0, 156, 536
"e:\Openlab\gitlib\project\pusch\pusch_dim_reduce\matlab\dynamic_truncation.m", "MATLAB", 14, 0, 12, 26
"e:\Openlab\gitlib\project\pusch\pusch_dim_reduce\matlab\gen_rom_mif.m", "MATLAB", 11, 0, 9, 20
"e:\Openlab\gitlib\project\pusch\pusch_dim_reduce\matlab\pdsch_dr_core_vfy.m", "MATLAB", 341, 0, 165, 506
"e:\Openlab\gitlib\project\pusch\pusch_dim_reduce\matlab\pdsch_dr_vfy.m", "MATLAB", 285, 0, 148, 433
"e:\Openlab\gitlib\project\pusch\pusch_dim_reduce\matlab\rec_vfy.m", "MATLAB", 497, 0, 187, 684
"e:\Openlab\gitlib\project\pusch\pusch_dim_reduce\matlab\untitled.m", "MATLAB", 75, 0, 43, 118
"e:\Openlab\gitlib\project\pusch\pusch_dim_reduce\matlab\untitled2222.m", "MATLAB", 495, 0, 185, 680
"e:\Openlab\gitlib\project\pusch\pusch_dim_reduce\matlab\write_hex2mif.m", "MATLAB", 21, 0, 12, 33
"e:\Openlab\gitlib\project\pusch\pusch_dim_reduce\matlab\write_mif.m", "MATLAB", 20, 0, 18, 38
"Total", "-", 4879, 0, 2205, 7084